$$$ exec p2 : [./resources/players/champely.filler]
Plateau 15 17:
    01234567890123456
000 .................
001 .................
002 .................
003 .................
004 .................
005 .................
006 .................
007 .................
008 ...O.............
009 .................
010 .................
011 .................
012 ..............XX.
013 .................
014 .................
Piece 2 3:
**.
.*.
